0 0 0 0 10 11 12 13 14 0 8 9 0 0 0 
0 6 7 0 0 0 0 0 0 0 0 0 0 0 0 
3 2 1 0 0 0 3 2 1 0 0 0 3 2 1 
4 0 4 0 0 0 4 0 4 0 0 0 4 0 4 
3 2 1 0 0 0 3 2 1 0 0 0 3 2 1 
4 0 4 0 0 0 4 0 4 0 0 0 4 0 4 
3 2 1 0 0 0 3 2 1 0 0 0 3 2 1 
4 0 4 0 0 0 4 0 4 0 0 0 4 0 4 
3 2 1 0 0 0 3 2 1 0 0 0 3 2 1 
4 0 4 0 0 0 4 0 4 0 0 0 4 0 4 
3 2 1 0 0 0 3 2 1 0 0 0 3 2 1 
4 0 4 0 0 0 4 0 4 0 0 0 4 0 4 
3 2 1 0 0 0 3 2 1 0 0 0 3 2 1 
4 0 4 0 0 0 4 0 4 0 0 0 4 0 4
3 2 1 0 0 0 3 2 1 0 0 0 5 2 1
4 0 4 0 0 0 4 0 4 0 0 0 4 0 4
